NO      textures/rougeavecdunoirsurlecote.xpm
SO    textures/rougeavecdunoirsurlecote.xpm




F    255,255,255
EA textures/rougeavecdunoirsurlecote.xpm

WE textures/rougeavecdunoirsurlecote.xpm



C 0,00,0

111111111111111111111111
1000000000110000000000001
1011000001110000000000001
10010000000000000000000011111111
111111111011000001110000000000001
100000000011000001110111111111111
11110111111111011100000010001
11110111111111011101010010001
11000000110101011100  0010001   
10000000000000001100000010001   
10000000000000001101010010001  
11000001110101011111011110S0111
11110111 1110101 101111010001
11111111 1111111 111111111111